Protons;p;Générer deux protons sur le senseur en utilisant un réacteur et un super-positron. Le réacteur est un élément qui nécessite l'activation.;0;99;-32;108;2;370;[0, 0, 0, 0, 0, 0, 0, 0, 0, 0, 0, 0, 2];[0, 0, 0, 0, 0, 0, 0, 0, 0, 0, 0, 0, 0];0;0;0;0;99999;99999;99999;99999
0;0;0;0;0;0;0;0;0;0;0;0;0;0;0;0;0;0
0;0;0;0;0;0;0;0;0;1;1;1;0;1;1;1;0;0
0;0;0;0;0;0;0;0;0;1;1;1;1;2;2;1;0;0
0;0;0;0;0;0;0;0;0;1;2;1;2;1;1;0;0;0
0;0;0;0;0;0;0;0;0;0;1;2;1;1;1;0;0;0
0;0;0;0;0;0;0;0;0;0;0;1;2;2;2;0;0;0
0;0;0;0;0;0;0;0;0;0;0;0;0;0;2;0;0;0
0;0;0;0;0;0;0;0;0;0;0;0;0;0;0;2;0;0
0;0;0;0;0;0;0;0;0;0;0;0;0;0;0;0;0;0
0;0;0;0;0;0;0;0;0;0;0;0;0;0;0;0;0;0
0;0;0;0;0;0;0;0;0;0;0;0;0;0;0;196609;0;0
0;0;0;0;0;0;0;0;0;0;196624;0;0;0;0;196629;0;0
0;0;0;0;0;0;0;0;0;0;0;0;0;0;0;0;0;0
0;0;0;0;0;0;0;0;0;0;0;0;0;0;196627;0;0;0
0;0;0;0;0;0;0;0;0;0;0;0;0;0;0;0;0;0
0;0;0;0;0;0;0;0;0;0;0;0;0;0;0;196635;0;0
0;0;0;0;0;0;0;0;0;0;0;0;0;0;0;0;0;0
0;0;0;0;0;0;0;0;0;0;0;0;0;0;0;0;0;0
